11111111
1P010001
10010101
1C000101
100001E1
11111111