1111111111111
1001000P00001
1000011111001
100011000E001
1111111111111