1111111111111
1001000P00001
1000011111C01
1000110000001
1111111111111