1111111111111
1001000C00001
1000011111C01
100011000E001
1111111111111