1111111
100C0P1
1110101
1E001C1
1111111